# # # # # # # # # # # # #
# 2 2 2 2 2 # 2 2 2 2 2 #
# 2 2 # # 2 # 2 # # 2 2 #
# # 2 # # 2 # 2 # # 2 # #
0 # 2 2 2 2 2 2 2 2 2 # 0
# # # 0 # # 4 # # 0 # # #
0 0 0 0 # 6 7 5 # 0 0 0 0
# # # 0 # # # # # 0 # # #
# 2 2 2 2 2 3 2 2 2 2 2 #
# 2 # 0 # 2 # 2 # 0 # # #
# 2 # 0 # 2 # 2 # 0 # 2 #
# 2 2 2 2 2 # 2 2 2 2 2 #
# # # # # # # # # # # # #