# # # # # # # # # # # # # # # # # # # # # # # # # 
# 1 2 2 2 2 # 2 2 2 2 1 # 2 2 2 0 # 2 2 2 2 2 1 #
# 2 2 2 2 2 # 2 2 2 2 2 # 2 2 2 0 # 2 # # # # 2 #
# 2 2 2 2 2 2 2 2 2 2 2 2 2 2 2 2 2 2 2 2 2 2 2 #
# 2 # # 2 2 # 2 # 2 2 2 2 2 2 2 # 2 # 2 # # 2 2 #
# 2 # # 2 2 # 2 # # # # # # # # # 2 # 2 # # 2 2 #
# 1 2 2 2 2 # 1 2 2 2 2 # 2 2 2 2 2 # 2 2 2 2 1 #
# # # # 2 2 # # # 2 2 # # # # # # # # 2 2 # # # #
# 2 2 2 2 2 2 2 2 2 2 2 0 2 2 2 2 2 2 2 2 2 2 1 #
# 2 # # 2 2 # # 2 2 # # 4 # # 2 2 # # 2 # # 2 2 #
0 2 # # 2 2 # # 2 2 # 6 7 5 # 2 2 # # 2 # # 2 2 0
# 2 2 2 2 2 # 2 2 2 # # # # # 2 2 2 # 2 2 1 2 2 #
# 2 # # 2 2 # # 2 2 2 2 2 2 2 2 2 # # 2 # # 2 2 #
# 2 # # 2 2 2 2 2 2 2 2 2 2 2 2 2 2 2 2 # # 2 2 #
# 2 # # 2 2 # # # # # # # # # # # 2 2 2 # # 2 2 #
# 2 # # 2 2 # 2 2 2 2 2 2 2 2 2 2 2 2 2 # # 2 2 #
# 2 2 1 2 2 2 2 2 2 2 2 # 2 2 2 2 2 2 2 2 2 2 1 #
# # # # 2 2 # # 2 # 2 # # # 2 # 2 # # 2 2 # # # #
# 1 2 2 2 2 # 2 2 2 2 2 # 2 2 2 2 2 # 2 2 2 2 1 #
# 2 # # 2 2 # 2 # # # # # # # # # 2 # 2 # # 2 2 #
# 2 # # 2 2 # 2 # 0 0 0 3 0 0 0 # 2 # 2 # # 2 2 #
# 2 2 2 2 2 2 2 # 0 0 0 2 0 0 0 # 2 2 2 2 2 2 2 #
# 2 # # 2 2 # 2 # # 0 0 2 0 0 # # 2 # 2 # # 2 2 #
# 1 2 2 2 2 # 2 2 2 2 2 2 2 2 2 2 2 # 2 2 2 2 1 #
# # # # # # # # # # # # # # # # # # # # # # # # #